############
# P   X  O #
#          #
#      ##  #
#          #
# OX       #
########## #
